....................................................................
.##################################################################.
.##################################################################.
.##################################################################.
.##################################################################.
.######TTTTTTTTTTTTTTTTT################TTTTTTTTTTTTTTTTT##########.
.######TTTTTTTTTTTTTTTTT################TTTTTTTTTTTTTTTTT##########.
.##################################################################.
.##################################################################.
.##################################################################.
.######TTTTTTTTTTTTTTTTT################TTTTTTTTTTTTTTTTT##########.
.######TTTTTTTTTTTTTTTTT################TTTTTTTTTTTTTTTTT##########.
.##################################################################.
.##################################################################.
.##################################################################.
.########################TTTTTTTTTTTTTTTTT#########################.
.########################TTTTTTTTTTTTTTTTT#########################.
.##################################################################.
.##################################################################.
.##################################################################.
.######TTTTTTTTTTTTTTTTT################TTTTTTTTTTTTTTTTT##########.
.######TTTTTTTTTTTTTTTTT################TTTTTTTTTTTTTTTTT##########.
.##################################################################.
.##################################################################.
.##################################################################.
.##################################################################.
.##################################################################.
....................................................................
