..........................................
.########################################.
.########################################.
.########################################.
.#####,,,########################,,,#####.
.#####,,,#########,,,,,,#########,,,#####.
.#####,,,#########,,,,,,#########,,,#####.
.#################,,,,,,#################.
.#################,,,,,,#################.
.#################,,,,,,#################.
.#####,,,#########,,,,,,#########,,,#####.
.#####,,,#########,,,,,,#########,,,#####.
.#####,,,########################,,,#####.
.########################################.
.#################TTTTTT#################.
.########################################.
.#####,,,########################,,,#####.
.#####,,,#########,,,,,,#########,,,#####.
.#####,,,#########,,,,,,#########,,,#####.
.#################,,,,,,#################.
.#################,,,,,,#################.
.#################,,,,,,#################.
.#####,,,#########,,,,,,#########,,,#####.
.#####,,,#########,,,,,,#########,,,#####.
.#####,,,########################,,,#####.
.########################################.
.########################################.
.########################################.
.########################################.
.########################################.
.##,,,###########################,,,#####.
.##,,,###########################,,,#####.
.##,,,###########################,,,#####.
.########################################.
.########################################.
.########################################.
..........................................
