..............................
.############################.
.############################.
.#######....######....#######.
.######......####......######.
.#####........##........#####.
.#####........##........#####.
.#####........##........#####.
.#####........##........#####.
.######......####......######.
.#######....######....#######.
.############################.
.############################.
.############################.
.#######....######....#######.
.######......####......######.
.#####........##........#####.
.#####........##........#####.
.#####........##........#####.
.#####........##........#####.
.######......####......######.
.#######....######....#######.
.############################.
.############################.
..............................