....................................................
.66666666776666666666666666666666666666666666666666.
.66666666666666666666666666666666666666666666666666.
.66666666666666666666665556666666666666666666666666.
.66666666666666666655555555556666666666666666666666.
.66666666666666665555544445555566666666666666666666.
.66666666666666555554444444455556666666666666666666.
.66666666666665555444333333444455566666666666666666.
.66666666666655544433333223333344455566666666666666.
.66666666666555543333222222223333444555666666666666.
.66666666665554433222221111222223333344555666666666.
.66666666655544333222111111111112223333345556666666.
.66666666555533322111111111111111122233333445566666.
.66666655554433211111111111111111112222333334455666.
.66666555544332111111111111111111111222223333344566.
.66655555443321111111111111111111111122222333334455.
.66555544433211111111111111111111111112222233333455.
.65555444332111111111111111111111111112222233333445.
.65554443321111111111111111111111111112222233333445.
.55544433211111111111111111111111111112222233333345.
.55444333211111111111111111111111111112222233333344.
.54443332111111111111111111111111111112222233333344.
.54433321111111111111111111111111111112222233333334.
.54333211111111111111111111111111111112222233333334.
.54333211111111111111111111111111111112222233333334.
.54332211111111111111111111111111111112222233333334.
.54332211111111111111111111111111111112222233333334.
.54332211111111111111111111111111111112222233333334.
.54333211111111111111111111111111111112222233333334.
.54433321111111111111111111111111111112222233333334.
.54443332111111111111111111111111111112222233333344.
.55444333211111111111111111111111111112222233333344.
.55544443321111111111111111111111111112222233333445.
.55555444332111111111111111111111111112222233333445.
.66555554433211111111111111111111111122222333333455.
.66655555443322111111111111111111112222223333334555.
.66666555554332211111111111111111112222333333334556.
.66666655555443322211111111111112222223333333445566.
.66666666555544333222111111111222222333333334455666.
.66666666655554433322222111122222233333333344556666.
.66666666665555544333222222222233333333334445566666.
.66666666666655555443333333333333333344444455666666.
.66666666666666555554444444444444444455555556666666.
.66666666666666655555555555555555555555555566666666.
.66666666666666666665555555555555555555666666666666.
.66666666666666666666666666666666666666666666666666.
.66666666666666666666666666666666666666666666666666.
.66666666666666666666666666666666666666666666666666.
.66666666666666666666666666666666666666666666666666.
.66666666666666666666666666666666666666666666666666.
....................................................