............................................................
.##########################################################.
.##########################################################.
.##########################################################.
.###########...##############################...###########.
.###########...############......############...###########.
.###########...############......############...###########.
.##########################......##########################.
.##########################......##########################.
.##########################......##########################.
.###########...############......############...###########.
.###########...############......############...###########.
.###########...##############################...###########.
.##########################################################.
.##########################TTTTTT##########################.
.##########################################################.
.###########...##############################...###########.
.###########...############......############...###########.
.###########...############......############...###########.
.##########################......##########################.
.##########################......##########################.
.##########################......##########################.
.###########...############......############...###########.
.###########...############......############...###########.
.###########...##############################...###########.
.##########################################################.
.##########################################################.
.##########################################################.
.##########################################################.
.##########################################################.
.###########...##############################...###########.
.###########...##############################...###########.
.###########...##############################...###########.
.##########################################################.
.##########################################################.
.##########################################################.
............................................................