..............................
.############################.
.############################.
.#######,,,,######,,,,#######.
.######,,,,,,####,,,,,,######.
.#####,,,,,,,,##,,,,,,,,#####.
.#####,,,,,,,,##,,,,,,,,#####.
.#####,,,,,,,,##,,,,,,,,#####.
.#####,,,,,,,,##,,,,,,,,#####.
.######,,,,,,####,,,,,,######.
.#######,,,,######,,,,#######.
.############################.
.############################.
.############################.
.#######,,,,######,,,,#######.
.######,,,,,,####,,,,,,######.
.#####,,,,,,,,##,,,,,,,,#####.
.#####,,,,,,,,##,,,,,,,,#####.
.#####,,,,,,,,##,,,,,,,,#####.
.#####,,,,,,,,##,,,,,,,,#####.
.######,,,,,,####,,,,,,######.
.#######,,,,######,,,,#######.
.############################.
.############################.
..............................