WWWWWWWWWWWWWWWWWWWWWWWWWWWWWWWWWWWWWWWWWWWWWWWWWWWWWWWWWWWWWWWWWWWW
W##################################################################W
W##################################################################W
W##################################################################W
W##################################################################W
W######TTTTTTTTTTTTTTTTT################TTTTTTTTTTTTTTTTT##########W
W######TTTTTTTTTTTTTTTTT################TTTTTTTTTTTTTTTTT##########W
W##################################################################W
W##################################################################W
W##################################################################W
W######TTTTTTTTTTTTTTTTT################TTTTTTTTTTTTTTTTT##########W
W######TTTTTTTTTTTTTTTTT################TTTTTTTTTTTTTTTTT##########W
W##################################################################W
W##################################################################W
W##################################################################W
W########################TTTTTTTTTTTTTTTTT#########################W
W########################TTTTTTTTTTTTTTTTT#########################W
W##################################################################W
W##################################################################W
W##################################################################W
W######TTTTTTTTTTTTTTTTT################TTTTTTTTTTTTTTTTT##########W
W######TTTTTTTTTTTTTTTTT################TTTTTTTTTTTTTTTTT##########W
W##################################################################W
W##################################################################W
W##################################################################W
W##################################################################W
W##################################################################W
WWWWWWWWWWWWWWWWWWWWWWWWWWWWWWWWWWWWWWWWWWWWWWWWWWWWWWWWWWWWWWWWWWWW
