...............................
.#############################.
.#############################.
.#############################.
.#######,,,,#######,,,,#######.
.######,,,,,,#####,,,,,,######.
.#####,,,,,,,,###,,,,,,,,#####.
.#####,,,,,,,,###,,,,,,,,#####.
.#####,,,,,,,,###,,,,,,,,#####.
.#####,,,,,,,,###,,,,,,,,#####.
.######,,,,,,#####,,,,,,######.
.#######,,,,#######,,,,#######.
.#############################.
.#############################.
.#############################.
.#######,,,,#######,,,,#######.
.######,,,,,,#####,,,,,,######.
.#####,,,,,,,,###,,,,,,,,#####.
.#####,,,,,,,,###,,,,,,,,#####.
.#####,,,,,,,,###,,,,,,,,#####.
.#####,,,,,,,,###,,,,,,,,#####.
.######,,,,,,#####,,,,,,######.
.#######,,,,#######,,,,#######.
.#############################.
.#############################.
.#############################.
...............................