..............................G................................................
.#############################################################################.
.######################################################################...####.
.##############################....###########E###############...######...####.
.##############################....###########################...######...####.
.##############################....###########################...######...####.
.##############################....###########################...######...####.
.##############################....###########################...######...####.
.##############################....###########################...#############.
.##############################....###############....########...#############.
.##############################....###############....########################.
.##############################....###############....########################.
.##############################....###############....########################.
.##############################....###############....########################.
.#####E########################....###############....########################.
.###########....###############....###############....########################.
.###########....###############....###############....########################.
.###########....###############....###############....########################.
.###########....###############....###############....########################.
.###########....###############....###############....########################.
.###########....###############....###############....########################.
.###########....###############....###############....########################.
.###########....###############....###############....########################.
.###########....###############....###############....########################.
.###########....###############....###############....########################.
.###########....###############....###############....########################.
.###########....###############....###############....########################.
.###########....##################################....########################.
.###########....##################################....########################.
.###########....##################################....########################.
.###########....##################################....##############E#########.
.###########....###########....###################....########################.
.###########....###########....###################....########################.
.###########....###########....###################....##############E#########.
.###########....###########....###################....########################.
.##########################....#####################################E#########.
.##########################....###############################################.
.############E#############....###############################################.
.##########################....###############################################.
...............................................................................