............................................................
.##########################################################.
.##########################################################.
.##########################################################.
.###########,,,##############################,,,###########.
.###########,,,############,,,,,,############,,,###########.
.###########,,,############,,,,,,############,,,###########.
.##########################,,,,,,##########################.
.##########################,,,,,,##########################.
.##########################,,,,,,##########################.
.###########,,,############,,,,,,############,,,###########.
.###########,,,############,,,,,,############,,,###########.
.###########,,,##############################,,,###########.
.##########################################################.
.##########################TTTTTT##########################.
.##########################################################.
.###########,,,##############################,,,###########.
.###########,,,############,,,,,,############,,,###########.
.###########,,,############,,,,,,############,,,###########.
.##########################,,,,,,##########################.
.##########################,,,,,,##########################.
.##########################,,,,,,##########################.
.###########,,,############,,,,,,############,,,###########.
.###########,,,############,,,,,,############,,,###########.
.###########,,,##############################,,,###########.
.##########################################################.
.##########################################################.
.##########################################################.
.##########################################################.
.##########################################################.
.###########,,,##############################,,,###########.
.###########,,,##############################,,,###########.
.###########,,,##############################,,,###########.
.##########################################################.
.##########################################################.
.##########################################################.
............................................................
