WWWWWWWWWWWWWWWWWWWWWWWWWWWWWWWWWWW
W#####WW############WW############W
W#####WW############WW############W
W#####WW############WW############W
W#####WW#####WW#####WW#####WW#####W
W#####WW#####WW#####WW#####WW#####W
W#####WW#####WW#####WW#####WW#####W
W#####WW#####WW#####WW#####WW#####W
W#####WW#####WW#####WW#####WW#####W
W#####WW#####WW#####WW#####WW#####W
W#####WW#####WW#####WW#####WW#####W
W#####WW#####WW#####WW#####WW#####W
W#####WW#####WW#####WW#####WW#####W
W#####WW#####WW#####WW#####WW#####W
W#####WW#####WW#####WW#####WW#####W
W#####WW#####WW#####WW#####WW#####W
W#####WW#####WW#####WW#####WW#####W
W#####WW#####WW#####WW#####WW#####W
W############WW############WW#####W
W############WW############WW#####W
W############WW############WW#####W
W############WW############WW#####W
WWWWWWWWWWWWWWWWWWWWWWWWWWWWWWWWWWW