WWWWWWWWW
########W
########W
########W
########W
########W
########W
########W
W#######W